{
	"floor": [
		"############",
		"#....#..#..#",
		"#.#..#.###.#",
		"#.#..#.....#",
		"#.####..####",
		"#.#..#..#..#",
		"#.#..#..#..#",
		"#.#.##.....#",
		"#.#.#...#..#",
		"#...#...#..#",
		"#.#...#.#..#",
		"#.#.#.#.#.##",
		"#.#.#.#....#",
		"############"
	],
	"legend": {
		"#": {
			"renderAs": "cube"
		},
		".": {
			"renderAs": false
		}
	}
}
